1111111
1000001
1110111
1010001
1000101
1010101
1111111